workload,numCycles,tlb_hits,read_hits,write_hits,tlb_misses,read_misses,write_misses,mshr_hits,mshr_stall_cycles,num_jobs,total_cycles,num_tasks,read_action_cycles,compute_action_cycles,write_action_cycles,num_macver_onW
TDLCA_Robot_Localization,257623446,56510,43562,12948,21346,15606,5740,30012,0,16,2562539,768,2401010,484096,811882,2694
0,1,57392,44321,13071,20464,14847,5617,29009,0,16,2539599,768,2375438,484096,834634,2916
0,2,57114,43844,13270,20742,15324,5418,29716,0,16,2541657,768,2379996,484096,826787,2726
0,3,60568,46969,13599,22152,15895,6257,31076,0,17,2596749,816,2430540,514352,832573,3008
0,4,56537,43788,12749,21319,15380,5939,29852,0,16,2561161,768,2395858,484096,819769,2628
0,5,57794,44369,13425,20062,14799,5263,28985,0,16,2531965,768,2373213,484096,782957,2915
0,6,51759,40016,11743,21233,15456,5777,29248,0,15,2515480,720,2359128,453840,806152,2232
0,7,57243,43990,13253,20613,15178,5435,29821,0,16,2550139,768,2393894,484096,816444,2473
TDLCA_Segmentation,182915678,139440,98926,40514,160512,120066,40446,140947,0,115,10892189,1840,10022769,4713085,3455871,15276
0,1,151462,107623,43839,187610,139929,47681,164456,0,130,10855875,2080,9874050,5327608,3553308,16343
0,2,141329,99537,41792,192527,144207,48320,169750,0,128,10883504,2048,9890451,5245667,3578111,14960
0,3,151590,107887,43703,210954,156801,54153,184439,0,139,10858550,2224,9771547,5696315,3665275,15961
0,4,142913,101030,41883,190943,142714,48229,167978,0,128,10932031,2048,9913227,5245700,3598534,15143
0,5,150603,106831,43772,180645,135009,45636,158546,0,127,10880117,2032,9902017,5204629,3598979,16707
0,6,121164,84266,36898,228340,170902,57438,201122,0,134,10899472,2144,9847161,5491519,3568920,12192
0,7,131453,93134,38319,189363,141090,48273,166389,0,123,10844540,1968,9914333,5040888,3473984,13463
TDLCA_EKF_SLAM,300780229,38964,10427,28537,11756,4197,7559,33089,0,16,2469172,256,1471113,594114,1859303,6250
0,1,35930,8932,26998,8166,2252,5914,28408,0,17,2130756,272,1271823,547656,1640242,5970
0,2,39433,10569,28864,11287,4055,7232,32507,0,16,2466449,256,1411641,594734,1865581,6700
0,3,34542,8398,26144,6962,2130,4832,25942,0,16,2117295,256,1192549,515127,1654112,6430
0,4,39336,10442,28894,11384,4182,7202,33110,0,16,2487377,256,1416128,594734,1874987,6218
0,5,32311,8014,24297,6601,1858,4743,24699,0,15,2061687,240,1162466,483791,1609094,5518
0,6,39433,10578,28855,11287,4046,7241,32626,0,16,2467907,256,1362959,594249,1877079,6569
0,7,36441,8969,27472,7655,2215,5440,28014,0,17,2136836,272,1334432,545809,1626096,6355
0,8,39237,10382,28855,11483,4242,7241,33114,0,16,2458392,256,1380948,594702,1848848,6272
0,9,34264,8343,25921,7240,2185,5055,26674,0,16,2099608,256,1155033,515376,1617686,5764
0,10,39677,10616,29061,11043,4008,7035,32436,0,16,2493287,256,1468276,594734,1877208,6729
0,11,33953,8322,25631,7551,2206,5345,26444,0,16,2065427,256,1111893,515328,1599334,6012
0,12,39268,10383,28885,11452,4241,7211,33768,0,16,2493668,256,1521198,594153,1875225,5613
0,13,32155,7954,24201,6757,1918,4839,25193,0,15,2051466,240,1089491,483676,1595860,5085
0,14,39069,10280,28789,11651,4344,7307,33612,0,16,2468608,256,1582621,594215,1844250,5887
0,15,33693,8271,25422,7811,2257,5554,27280,0,16,2074646,256,1272372,514662,1574913,5228
TDLCA_Disparity_Map,72181911,18951,12572,6379,565,212,353,956,0,153,2115097,2448,1471495,122890,1651497,5633
0,1,24476,20333,4143,232,151,81,73,0,16,2622510,512,2427846,135168,1432545,4134
0,2,182926,90014,92912,2926,2926,0,67568,0,298,4717564,2384,4321463,197768,3058035,27410
0,3,18696,12407,6289,552,197,355,811,0,151,2107086,2416,1471010,121293,1635641,5663
0,4,24479,20335,4144,229,149,80,63,0,16,2572799,512,2385012,135168,1398249,4144
0,5,187142,92190,94952,2793,2793,0,67299,0,296,4728844,2368,4348217,196457,3021101,29578
0,6,17695,11727,5968,529,205,324,644,0,143,2118317,2288,1404611,114054,1676297,5478
0,7,24477,20333,4144,231,151,80,63,0,16,2594895,512,2402150,135168,1431823,4144
0,8,181407,89291,92116,2856,2856,0,66387,0,292,4710237,2336,4314827,193832,3088917,27720
0,9,18186,12095,6091,554,177,377,703,0,147,2107561,2352,1518922,118775,1621287,5584
0,10,24480,20336,4144,228,148,80,63,0,16,2552363,512,2368362,135168,1389663,4144
0,11,183747,90523,93224,2732,2732,0,65588,0,293,4710041,2344,4316088,194433,3039872,29506
0,12,17831,11831,6000,529,193,336,647,0,144,2118587,2304,1434868,114958,1658595,5531
0,13,24477,20333,4144,231,151,80,63,0,16,2573217,512,2382979,135168,1425576,4144
0,14,179334,88282,91052,2796,2796,0,65475,0,292,4732740,2336,4333298,193812,3124315,27507
0,15,17966,11921,6045,530,195,335,617,0,145,2113276,2320,1543624,117439,1651274,5608
0,16,26014,21611,4403,238,153,85,63,0,17,2690271,544,2491552,143616,1479557,4403
0,17,187395,92311,95084,2805,2805,0,67290,0,299,4718559,2392,4328160,198445,3038852,29718
0,18,16444,10929,5515,516,179,337,697,0,133,2105991,2128,1312107,105076,1682352,5012
0,19,22942,19057,3885,222,147,75,64,0,15,2635780,480,2438857,126720,1473575,3885
0,20,134486,66030,68456,2451,2451,0,46315,0,250,4708310,2000,4358810,165951,3097170,23820
0,21,16801,11169,5632,535,183,352,615,0,136,2105726,2176,1451720,109049,1645155,5198
0,22,24476,20332,4144,232,152,80,64,0,16,2704215,512,2505158,135168,1491346,4144
0,23,169976,83532,86444,2939,2939,0,63281,0,284,4719759,2272,4332678,188481,3126184,25238
TDLCA_Swaptions,109900453,3696,173,3523,816,19,797,3490,0,8,222255,64,19494,70464,185582,772
0,1,6314,3086,3228,2294,1234,1060,4748,0,8,317063,64,141849,270336,205594,622
0,2,12415,6716,5699,3297,1892,1405,7547,0,8,727897,128,678563,122368,407303,1184
0,3,29993,18417,11576,9719,5743,3976,18436,0,8,1475324,192,1382997,253824,635701,2209
0,4,3900,168,3732,612,24,588,3447,0,8,222633,64,19783,70689,186467,826
0,5,7090,3464,3626,1518,856,662,4288,0,8,316219,64,145281,270336,218275,712
0,6,12404,6721,5683,3308,1887,1421,7470,0,8,721187,128,675769,122368,408378,1257
0,7,29850,18286,11564,9862,5874,3988,18323,0,8,1440645,192,1346747,253824,622088,2450
0,8,3749,167,3582,763,25,738,3505,0,8,222253,64,22302,70824,186086,765
0,9,6933,3306,3627,1675,1014,661,4493,0,8,321363,64,141470,270336,209782,663
0,10,12180,6518,5662,3532,2090,1442,7778,0,8,723756,128,667498,122368,407385,1149
0,11,29206,17852,11354,10506,6308,4198,19135,0,8,1472604,192,1380849,253824,638688,2063
0,12,3731,167,3564,781,25,756,3416,0,8,222688,64,25554,70824,186931,850
0,13,6778,3252,3526,1830,1068,762,4528,0,8,308653,64,143294,270336,209231,681
0,14,12176,6418,5758,3536,2190,1346,7767,0,8,718451,128,672588,122368,401065,1257
0,15,29819,18462,11357,9893,5698,4195,18313,0,8,1455384,192,1365170,253824,619431,2276
0,16,3693,167,3526,819,25,794,3490,0,8,222767,64,15373,70584,188327,772
0,17,6608,3134,3474,2000,1186,814,4698,0,8,311786,64,129591,270336,202259,628
0,18,12693,6953,5740,3019,1655,1364,7298,0,8,717952,128,673508,122368,397198,1199
0,19,29501,17912,11589,10211,6248,3963,18913,0,8,1431850,192,1341814,253824,603133,2239
0,20,3779,171,3608,733,21,712,3391,0,8,219697,64,16232,70584,185990,873
0,21,6983,3410,3573,1625,910,715,4294,0,8,316134,64,148443,270336,220528,760
0,22,12622,6797,5825,3090,1811,1279,7346,0,8,720445,128,674529,122368,392889,1303
0,23,29788,18400,11388,9924,5760,4164,18278,0,8,1435046,192,1339706,253824,624806,2384
0,24,3857,174,3683,655,18,637,3558,0,8,221131,64,19464,70584,186996,709
0,25,6650,3167,3483,1958,1153,805,4705,0,8,316632,64,124111,270336,218155,589
0,26,12430,6771,5659,3282,1837,1445,7588,0,8,726481,128,675414,122368,429911,1091
0,27,29260,17636,11624,10452,6524,3928,19465,0,8,1471850,192,1384405,253824,633759,1965
0,28,3617,165,3452,895,27,868,3526,0,8,222285,64,19225,70584,185027,739
0,29,6563,3207,3356,2045,1113,932,4638,0,8,316268,64,148264,270336,215453,611
0,30,11762,6061,5701,3950,2547,1403,8258,0,8,731574,128,679669,122368,405231,1121
0,31,29635,17945,11690,10077,6215,3862,19069,0,8,1489473,192,1394973,253824,647355,2034
TDLCA_StreamCluster,112745958,17984,9076,8908,448,140,308,5984,0,2,765143,1024,621644,263028,624362,3112
0,1,54581,53437,1144,875,867,8,160,0,16,8730123,768,8646057,569714,113115,1133
0,2,7383,3342,4041,169,114,55,88,0,16,1181703,384,1125310,461388,0,4019
0,3,108961,107833,1128,863,839,24,101,0,16,8932350,768,8845349,578438,115874,1128
0,4,7398,6246,1152,154,154,0,79,0,16,698461,256,672724,94571,121102,1152
0,5,0,0,0,0,0,0,0,0,0,0,0,0,0,0,0
0,6,54551,53401,1150,905,903,2,171,0,16,8665808,768,8583203,571125,101784,1140
0,7,7360,3335,4025,192,121,71,90,0,16,1136763,384,1087620,408441,0,4018
0,8,109033,107888,1145,791,784,7,68,0,16,9045036,768,8959380,576862,104781,1145
0,9,7425,6273,1152,127,127,0,49,0,16,681547,256,658021,89897,109150,1152
0,10,0,0,0,0,0,0,0,0,0,0,0,0,0,0,0
0,11,54523,53375,1148,933,929,4,187,0,16,8633097,768,8549057,575658,113021,1135
0,12,7386,3339,4047,166,117,49,89,0,16,1181078,384,1124565,465201,0,4021
0,13,108530,107395,1135,910,893,17,117,0,16,8837935,768,8751064,578657,116436,1129
0,14,7401,6249,1152,151,151,0,79,0,16,697431,256,672074,95277,119374,1152
0,15,0,0,0,0,0,0,0,0,0,0,0,0,0,0,0
0,16,54554,53406,1148,902,898,4,151,0,16,8626376,768,8543499,571005,102354,1141
0,17,7376,3339,4037,176,117,59,89,0,16,1133877,384,1082580,408137,0,4017
0,18,108823,107695,1128,873,849,24,68,0,16,8858928,768,8773246,577948,105773,1128
0,19,7400,6248,1152,152,152,0,79,0,16,677312,256,653247,96780,107702,1152
0,20,0,0,0,0,0,0,0,0,0,0,0,0,0,0,0
0,21,54619,53467,1152,837,837,0,130,0,16,8591981,768,8507968,571892,113658,1146
0,22,7388,3336,4052,164,120,44,87,0,16,1174797,384,1117323,453488,0,4018
0,23,108963,107814,1149,861,858,3,110,0,16,8771629,768,8684767,576578,115878,1145
0,24,7395,6243,1152,157,157,0,79,0,16,693636,256,668760,92903,120629,1152
0,25,0,0,0,0,0,0,0,0,0,0,0,0,0,0,0
0,26,54597,53460,1137,859,844,15,139,0,16,8561078,768,8478413,569712,102427,1130
0,27,8104,3547,4557,176,125,51,89,0,17,1205386,408,1147793,460307,0,4531
0,28,108483,107336,1147,829,824,5,67,0,16,8781451,768,8695900,578219,104851,1147
0,29,7402,6250,1152,150,150,0,79,0,16,671012,256,647171,96253,107597,1152
0,30,0,0,0,0,0,0,0,0,0,0,0,0,0,0,0
0,31,54678,53526,1152,778,778,0,119,0,16,9191443,768,9104154,573591,136975,1146
0,32,6657,3126,3531,167,114,53,90,0,15,1166730,360,1107860,468075,0,3504
0,33,108919,107769,1150,777,775,2,106,0,16,9311609,768,9221541,577474,142343,1150
0,34,7395,6243,1152,157,157,0,79,0,16,735700,256,706004,98755,142697,1152
0,35,0,0,0,0,0,0,0,0,0,0,0,0,0,0,0
0,36,54675,53523,1152,781,781,0,129,0,16,8939183,768,8853719,572461,124570,1141
0,37,7384,3337,4047,168,119,49,89,0,16,1239406,384,1177235,503653,0,4021
0,38,108866,107730,1136,830,814,16,112,0,16,9092588,768,9004020,577957,128937,1132
0,39,7399,6247,1152,153,153,0,79,0,16,716830,256,690260,95673,130813,1152
TDLCA_Denoise,235719374,69018,36730,32288,75398,46246,29152,84017,0,16,5098197,128,4268397,2097449,2710383,10737
0,1,49849,34921,14928,238951,192439,46512,223278,0,16,8519080,384,7732726,3932541,2272396,4640
0,2,76278,41175,35103,77162,46985,30177,86287,0,17,5409520,136,4614736,2228542,2788518,12343
0,3,52134,35585,16549,236666,191775,44891,221550,0,16,8491549,384,7784671,3932544,2224229,5479
0,4,68722,37011,31711,75694,45965,29729,83759,0,16,5218363,128,4366286,2097455,2742082,10676
0,5,48964,33802,15162,239836,193558,46278,224186,0,16,8505616,384,7777180,3932544,2231038,4690
0,6,68963,37782,31181,57405,34826,22579,65807,0,14,5280392,112,4657267,1835296,2585539,11463
0,7,51148,35544,15604,237652,191816,45836,221816,0,16,8446862,384,7738810,3932544,2232051,5152
0,8,70157,36754,33403,83283,51406,31877,92051,0,17,5227629,136,4398685,2228533,2705928,11055
0,9,49176,33776,15400,239624,193584,46040,224031,0,16,8494626,384,7767446,3932544,2219235,4757
0,10,75632,39758,35874,86832,53586,33246,95825,0,18,5379465,144,4597681,2359611,2763502,12397
0,11,53065,38028,15037,235735,189332,46403,219630,0,16,8501357,384,7730183,3932541,2255562,4921
0,12,66831,35407,31424,86609,52753,33856,94638,0,17,5342225,136,4425147,2228548,2831543,9470
0,13,45465,30941,14524,243335,196419,46916,227597,0,16,8530289,384,7715516,3932535,2259232,4153
0,14,61405,33950,27455,55939,33474,22465,63490,0,13,5167026,104,4635115,1704227,2535176,9335
0,15,46795,31632,15163,242005,195728,46277,226495,0,16,8513481,384,7710952,3932535,2243773,4478
TDLCA_BlackScholes,74118448,18431,15825,2606,2569,2175,394,3194,0,125,897041,6000,824607,130000,523654,945
0,1,18613,15963,2650,2723,2325,398,3325,0,127,900157,6096,829983,132080,519831,984
0,2,19041,16352,2689,2799,2368,431,3383,0,130,892952,6240,819170,135200,524900,957
0,3,18143,15571,2572,2689,2285,404,3210,0,124,895960,5952,830214,128960,497967,945
0,4,18934,16252,2682,2738,2324,414,3365,0,129,896452,6192,824558,134160,519055,963
0,5,17880,15342,2538,2616,2226,390,3146,0,122,899042,5856,833787,126880,499050,944
0,6,19721,16909,2812,3127,2675,452,3692,0,136,888625,6528,811133,141440,546916,973
0,7,19129,16412,2717,2879,2452,427,3466,0,131,890235,6288,816199,136240,530032,954
